0019 0002 0002 0002 0002 0002 0002 0002 0002 0002 0002 0002 0002 0002 0002 0002 0002 0002 0002 0002 0002 0002 0002 0002 0016
0005 0000 0000 0000 0000 0000 0000 0000 0000 0000 0000 0000 0000 0000 0000 0000 0000 0000 0000 0000 0000 0000 0000 0000 0003
0005 0000 0000 0000 0000 0000 0000 0000 0000 0000 0000 0000 0000 0000 0000 0000 0000 0000 0000 0000 0000 0000 0000 0000 0003
0005 0000 0000 0000 0000 0000 0000 0000 0012 0000 0000 0015 0011 0013 0000 0000 0012 0000 0000 0000 0000 0000 0000 0000 0003
0005 0000 0000 0015 0011 0013 0000 0000 0010 0000 0000 0000 0000 0000 0000 0000 0010 0000 0000 0015 0011 0013 0000 0000 0003
0005 0000 0000 0000 0000 0000 0000 0000 0010 0000 0000 0000 0000 0000 0000 0000 0010 0000 0000 0000 0000 0000 0000 0000 0003
0005 0000 0000 0000 0000 0000 0000 0000 0014 0000 0000 0000 0000 0000 0000 0000 0014 0000 0000 0000 0000 0000 0000 0000 0003
0005 0000 0000 0000 0000 0000 0000 0000 0000 0000 0000 0000 0000 0000 0000 0000 0000 0000 0000 0000 0000 0000 0000 0000 0003
0005 0000 0000 0000 0000 0000 0000 0000 0000 0000 0000 0000 0000 0000 0000 0000 0000 0000 0000 0000 0000 0000 0000 0000 0003
0005 0000 0000 0000 0000 0000 0000 0000 0000 0000 0000 0000 0000 0000 0000 0000 0000 0000 0000 0000 0000 0000 0000 0000 0003
0005 0000 0000 0000 0000 0000 0000 0000 0000 0000 0000 0000 0000 0000 0000 0000 0000 0000 0000 0000 0000 0000 0000 0000 0003
0005 0000 0000 0000 0000 0000 0000 0000 0012 0000 0000 0000 0000 0000 0000 0000 0012 0000 0000 0000 0000 0000 0000 0000 0003
0005 0000 0000 0000 0000 0000 0000 0000 0010 0000 0000 0000 0000 0000 0000 0000 0010 0000 0000 0000 0000 0000 0000 0000 0003
0005 0000 0000 0015 0011 0013 0000 0000 0010 0000 0000 0000 0000 0000 0000 0000 0010 0000 0000 0015 0011 0013 0000 0000 0003
0005 0000 0000 0000 0000 0000 0000 0000 0014 0000 0000 0015 0011 0013 0000 0000 0014 0000 0000 0000 0000 0000 0000 0000 0003
0005 0000 0000 0000 0000 0000 0000 0000 0000 0000 0000 0000 0000 0000 0000 0000 0000 0000 0000 0000 0000 0000 0000 0000 0003
0005 0000 0000 0000 0000 0000 0000 0000 0000 0000 0000 0000 0000 0000 0000 0000 0000 0000 0000 0000 0000 0000 0000 0000 0003
0018 0004 0004 0004 0004 0004 0004 0004 0004 0004 0004 0004 0004 0004 0004 0004 0004 0004 0004 0004 0004 0004 0004 0004 0017